7 30
..............................
..............................
T..P........................T.
T........................Q..T.
T...........................T.
T5TTTTTTTTTTTTTTTTTTTTTTTTTTT.
..............................